8.Px
........
.P......
....P...
........
P...P...
........
........
......P.
